-1,-1,-1,-1,-1,-1,142,142,142,142,142,142,-1,-1,-1,-1,-1,-1,-1,-1,-1,-1,-1,-1,-1,-1,142,142,142,142,142,142,142,142,142,142,142,142,142,142,142,142,142,142,142,142,142,142,142,142,142,142,142,142,142,142,142,142,142,142,142,142,142,142,142,142,142,142,142,142,142,142,142,142,142,142,142,142,142,142,142,142,142,142,142,142,142,142,142,142,142,142,142,142,142,142,142,142,142,142,142,142,142,142,142,142,142,142,142,142,142,142,142,142,142,142,142,142,142,142,142,142,142,142,142,142,142,142,142,142,142,142,142,142,142,-1,-1,-1,-1,-1
-1,-1,-1,-1,-1,142,142,-1,-1,-1,-1,142,142,-1,-1,-1,-1,-1,-1,-1,-1,-1,-1,-1,-1,142,142,-1,-1,-1,-1,-1,-1,-1,-1,-1,-1,-1,-1,142,-1,-1,-1,-1,-1,-1,-1,-1,-1,-1,-1,291,-1,-1,-1,-1,-1,-1,-1,142,-1,-1,-1,-1,-1,-1,-1,-1,-1,-1,-1,-1,-1,-1,-1,142,-1,-1,-1,-1,-1,-1,-1,-1,142,142,-1,-1,-1,-1,-1,-1,-1,-1,-1,-1,-1,-1,-1,-1,-1,-1,-1,-1,-1,-1,-1,-1,-1,-1,-1,-1,-1,-1,-1,-1,-1,-1,-1,-1,-1,-1,-1,-1,-1,-1,-1,-1,-1,-1,-1,-1,-1,-1,142,-1,-1,-1,-1,-1
142,142,142,142,142,142,-1,-1,-1,-1,-1,-1,142,142,142,142,142,142,142,142,142,142,142,142,142,142,-1,-1,-1,-1,-1,-1,-1,-1,-1,-1,-1,-1,-1,142,-1,-1,-1,-1,-1,-1,-1,-1,-1,-1,-1,305,-1,-1,-1,-1,-1,-1,-1,142,-1,-1,-1,-1,-1,-1,-1,-1,-1,-1,-1,-1,-1,-1,-1,142,-1,-1,-1,-1,-1,-1,-1,-1,142,142,-1,-1,-1,-1,-1,-1,-1,-1,-1,-1,-1,-1,-1,-1,-1,-1,-1,-1,-1,-1,-1,-1,-1,-1,-1,-1,-1,-1,-1,-1,-1,-1,-1,-1,-1,-1,-1,-1,-1,-1,-1,-1,308,309,-1,-1,-1,-1,142,-1,-1,-1,-1,-1
142,-1,-1,-1,-1,-1,-1,-1,270,270,-1,-1,-1,-1,-1,-1,-1,-1,-1,-1,-1,-1,-1,-1,-1,-1,-1,-1,-1,-1,-1,-1,-1,-1,-1,-1,-1,-1,-1,142,-1,-1,73,142,142,72,-1,-1,-1,73,142,142,142,-1,-1,-1,-1,271,271,142,-1,-1,-1,142,142,142,-1,-1,-1,-1,-1,271,-1,-1,-1,142,-1,73,142,271,271,-1,-1,-1,142,142,-1,-1,-1,-1,-1,-1,-1,-1,-1,-1,-1,-1,-1,-1,-1,-1,-1,-1,-1,-1,-1,271,271,-1,-1,-1,271,271,-1,-1,-1,271,-1,-1,286,290,-1,-1,-1,-1,290,-1,322,323,-1,290,-1,-1,142,-1,-1,-1,-1,-1
142,-1,-1,-1,-1,-1,-1,-1,142,142,-1,-1,-1,-1,-1,-1,-1,-1,-1,-1,-1,-1,-1,-1,-1,-1,-1,-1,-1,73,72,-1,-1,142,142,142,-1,-1,-1,142,-1,-1,-1,142,142,-1,-1,-1,-1,-1,142,-1,142,-1,-1,-1,-1,142,142,142,72,-1,-1,142,-1,142,-1,-1,-1,-1,281,142,-1,-1,-1,142,-1,-1,142,-1,-1,271,-1,271,142,142,-1,-1,-1,-1,-1,-1,-1,-1,-1,-1,-1,-1,-1,-1,-1,-1,-1,-1,-1,-1,-1,142,142,-1,-1,-1,142,142,-1,-1,-1,142,-1,-1,-1,142,142,142,142,142,142,142,142,142,142,142,142,142,142,-1,-1,-1,-1,-1
142,-1,285,-1,-1,-1,-1,-1,142,142,-1,-1,-1,-1,-1,-1,-1,-1,-1,-1,-1,-1,-1,-1,-1,-1,-1,-1,-1,-1,-1,-1,-1,142,-1,142,271,-1,271,142,60,-1,-1,142,142,307,-1,-1,-1,73,142,-1,142,271,271,271,-1,-1,-1,-1,-1,-1,-1,142,-1,142,-1,-1,-1,-1,142,142,271,-1,271,142,72,-1,142,-1,-1,142,-1,142,142,142,60,60,60,142,142,-1,-1,-1,-1,-1,281,271,271,271,-1,-1,-1,-1,-1,281,-1,142,142,-1,281,-1,142,142,-1,281,-1,-1,-1,-1,-1,142,142,142,-1,-1,-1,-1,-1,-1,-1,-1,-1,-1,-1,-1,-1,-1,-1,-1
142,-1,-1,-1,-1,-1,281,-1,142,142,-1,-1,290,-1,-1,-1,142,142,142,142,142,-1,-1,-1,-1,-1,-1,-1,-1,-1,-1,-1,-1,142,-1,142,142,-1,142,142,-1,-1,-1,142,142,-1,-1,-1,-1,-1,142,-1,142,142,142,142,-1,-1,-1,-1,-1,-1,-1,142,-1,142,-1,-1,-1,-1,-1,142,142,-1,142,142,-1,-1,142,-1,142,142,-1,142,142,142,-1,-1,-1,142,142,-1,-1,-1,-1,-1,60,142,142,142,-1,281,-1,-1,-1,60,-1,-1,-1,-1,60,-1,-1,-1,-1,60,-1,-1,-1,281,-1,-1,-1,142,-1,-1,-1,-1,-1,-1,-1,-1,-1,-1,-1,-1,-1,-1,-1,-1
142,142,142,142,142,142,142,142,142,142,142,142,142,142,142,142,-1,-1,-1,-1,142,-1,-1,-1,-1,-1,-1,-1,-1,-1,-1,281,-1,142,-1,-1,142,-1,-1,-1,-1,-1,60,142,142,-1,-1,-1,-1,281,142,-1,142,-1,-1,-1,-1,-1,-1,-1,-1,281,-1,142,-1,142,271,271,281,271,271,142,-1,-1,-1,-1,-1,73,142,-1,142,-1,-1,-1,-1,-1,-1,-1,-1,142,142,-1,-1,-1,-1,-1,-1,142,-1,142,-1,60,-1,-1,-1,-1,-1,-1,-1,-1,-1,-1,-1,-1,-1,-1,-1,-1,-1,60,-1,-1,-1,142,-1,-1,-1,-1,-1,-1,-1,-1,-1,-1,-1,-1,-1,-1,-1,-1
-1,-1,-1,-1,-1,-1,-1,-1,-1,-1,-1,-1,-1,-1,-1,-1,-1,-1,-1,-1,142,271,271,271,271,271,142,142,142,142,142,142,142,142,-1,-1,142,-1,-1,-1,-1,-1,-1,142,142,290,290,-1,-1,142,142,-1,142,-1,-1,-1,-1,271,271,142,142,142,142,142,-1,142,142,142,142,142,142,142,-1,-1,-1,-1,-1,-1,142,-1,142,-1,-1,-1,-1,-1,-1,281,-1,142,142,271,271,271,271,271,271,142,-1,142,271,271,271,271,271,271,271,271,271,271,271,271,271,271,271,271,271,271,271,271,271,271,271,142,-1,-1,-1,-1,-1,-1,-1,-1,-1,-1,-1,-1,-1,-1,-1,-1
-1,-1,-1,-1,-1,-1,-1,-1,-1,-1,-1,-1,-1,-1,-1,-1,-1,-1,-1,-1,142,142,142,142,142,142,142,-1,-1,-1,-1,-1,-1,-1,-1,-1,142,142,142,142,142,142,142,142,142,142,142,142,142,142,142,-1,142,142,142,142,142,142,142,142,-1,-1,-1,-1,-1,-1,-1,-1,-1,-1,-1,142,142,142,142,142,142,142,142,142,142,142,142,142,142,142,142,142,142,142,142,142,142,142,142,142,142,142,-1,142,142,142,142,142,142,142,142,142,142,142,142,142,142,142,142,142,142,142,142,142,142,142,142,142,-1,-1,-1,-1,-1,-1,-1,-1,-1,-1,-1,-1,-1,-1,-1,-1
